111111111
1000000E1
1C0XX00C1
1P0XX0C11
111111111
