111111111111111111111
1PPPPPPPPPPPPPPPPPPP1
1PPPPPPPPPPPPPPPPPPP1
1PPPPPPPPPPPPPPPPPPP1
111111111111111111111
