1111111111111111111111111111111
1E0000000000C00000C000000000001
1010010100000101001000000010101
1010010001010001001000000010101
1P0000000C0000000000000000000C1
1111111111111111111111111111111
