111111111111111111111
1C0000CCCC000000000C1
10001010000X0001C0011
1P001E1000X0000CCCC01
111111111111111111111
