111111111111111111111111111111111111111111111111111111111
1P00000CCCCCCCCCC0000000000000000000000000CCCCCCC000001E1
111111111111111111111111111111111111111111111111111111111
